%%%%%%%
%    P%
% %%% %
% G%  %
%%   %%
%. %%%%
%%%%%%%
